111111111111111111111111111111111111111111111111111111111111111111111111111111111111111111111111111111111111111111111111111111111111111111111111111111111111111111111111111111111111111111111111111111111111111111111111111111111111111111111111111111
1                                                                                                                                                                                                                                                   11                                     
1                                                                                              M                         M                                                                              M                                           11
1                                               S                                           S             SS                                                  11111111111111                                                                        11                                      
1                                            111111            M  11111         S       111111       1111111                         S                   1111                                                                                       11                                        
1111111       S       11           11111                111                 111111                                                      111111       111                            M               M                                               11                                           
1     11     111111          11                                                                                                      11111                                                                                                          11                                       
1                                                                                                                         SS                                                                                                                     P  11                                           
1                                                                   M               M                                 1111111                                                      1     11     1111     11111     111111     11111    111111111111111
1                                                                                                             S             111                                           SS     111                                                                11
1                                                                  S                            SS        111111111                                               11DDD111111111                                                                    11                      
1                         S                                    11DD11111      S             111111DD1111                         111111111                S    111111                                  M           M                                11    
1                    111111111111                S    11111                11111111DD11                   M                       M    111111DDDDD111111111111                                                                                      11                            
1      X       1111                 1111111DD1111111                                                                                                                                                                                                11
1111111111111111DDDDDDDDDDDDDDDDDDDDDDDDDDDDDDDDDDDDDDDDDDDDDDDDDDDDDDDDDDDDDDDDDDDDDDDDDDDDDDDDDDDDDDDDDDDDDDDDDDDDDDDDDDDDDDDDDDDDDDDDDDDDDDDDDDDDDDDDDDDDDDDDDDDDDDDDDDDDDDDDDDDDDDDDDDDDDDDDDDDDDDDDDDDDDDDDDDDDDDDDDDDDDDDDDDDDDDDDDDDDDDDDDDDDDD
111111111111111111111111111111111111111111111111111111111111111111111111111111111111111111111111111111111111111111111111111111111111111111111111111111111111111111111111111111111111111111111111111111111111111111111111111111111111111111111111111111
111111111111111111111111111111111111111111111111111111111111111111111111111111111111111111111111111111111111111111111111111111111111111111111111111111111111111111111111111111111111111111111111111111111111111111111111111111111111111111111111111111
111111111111111111111111111111111111111111111111111111111111111111111111111111111111111111111111111111111111111111111111111111111111111111111111111111111111111111111111111111111111111111111111111111111111111111111111111111111111111111111111111111
111111111111111111111111111111111111111111111111111111111111111111111111111111111111111111111111111111111111111111111111111111111111111111111111111111111111111111111111111111111111111111111111111111111111111111111111111111111111111111111111111111
111111111111111111111111111111111111111111111111111111111111111111111111111111111111111111111111111111111111111111111111111111111111111111111111111111111111111111111111111111111111111111111111111111111111111111111111111111111111111111111111111111
111111111111111111111111111111111111111111111111111111111111111111111111111111111111111111111111111111111111111111111111111111111111111111111111111111111111111111111111111111111111111111111111111111111111111111111111111111111111111111111111111111