111111111111111111111111111111111111111111111111111111111111111111111111111111111111111111111111111111111111111111111111111111111111111111111111111111111111111111111111111111111111111111111111111111111111111111111111111111111111111111111111111111
1                                                                                                                                                                                                                                                   11                                     
1    11111                               M                     M                  M                        M                                                M                                                                           M           11
1                                                   11111                               1111                                     111111111111111111111                              M        111111111                                 M            11                                      
1                              111111111111111                     1111111111111                                   111111                                    1111111111111111                                                               M       11                                          
1      1111111111      111                                                                         1111111111                                                                    1111111111                                       M                 11                                           
1                                                                                                                                                                                                                                            M      11                                       
1                                                            M                                                                                            M                              M                                      SSS                 11                                           
1                                      M                                       M                                                                                                                       11111DDDDDD11111DDDDDD1111111111111111111111111                                            
1                                                                                             S             M                                M                                M                      111                                            11
1                                                 S      11111111                      111111111                           SS                                                                     111                                     M         11                      
1    X       S                         1111    111111                    SS       1111111              SSS        11DDD1111111DDD11            S        S                     SS      S        111                                 M            M   11    
11111111111111111111     11DDDD1111                    M           11111111111                     1111111111                            111111111111111111111111DDDDD111111111111111111111111111                                                   11                            
1                                                                                                                                                                                                                                        M          11
1DDDDDDDDDDDDDDDDDDDDDDDDDDDDDDDDDDDDDDDDDDDDDDDDDDDDDDDDDDDDDDDDDDDDDDDDDDDDDDDDDDDDDDDDDDDDDDDDDDDDDDDDDDDDDDDDDDDDDDDDDDDDDDDDDDDDDDDDDDDDDDDDDDDDDDDDDDDDDDDDDDDDDDDDDDDDDDDDDDDDDDDDDDDDDDDDDDDDDDDDDDDDDDDDDDDDDDDDDDDDDDDDDDDDDDDDDDDDDDDDDDDDD
111111111111111111111111111111111111111111111111111111111111111111111111111111111111111111111111111111111111111111111111111111111111111111111111111111111111111111111111111111111111111111111111111111111111111111111111111111111111111111111111111111
111111111111111111111111111111111111111111111111111111111111111111111111111111111111111111111111111111111111111111111111111111111111111111111111111111111111111111111111111111111111111111111111111111111111111111111111111111111111111111111111111111
111111111111111111111111111111111111111111111111111111111111111111111111111111111111111111111111111111111111111111111111111111111111111111111111111111111111111111111111111111111111111111111111111111111111111111111111111111111111111111111111111111
111111111111111111111111111111111111111111111111111111111111111111111111111111111111111111111111111111111111111111111111111111111111111111111111111111111111111111111111111111111111111111111111111111111111111111111111111111111111111111111111111111
111111111111111111111111111111111111111111111111111111111111111111111111111111111111111111111111111111111111111111111111111111111111111111111111111111111111111111111111111111111111111111111111111111111111111111111111111111111111111111111111111111
111111111111111111111111111111111111111111111111111111111111111111111111111111111111111111111111111111111111111111111111111111111111111111111111111111111111111111111111111111111111111111111111111111111111111111111111111111111111111111111111111111